8.ox
........
........
........
..oo....
.....o..
.o..o...
........
o.......
